# 10 items in row.
# separate levels by =====
#
0,2,2,0,1,1,0,2,2,0
0,0,1,2,0,0,2,1,0,0
0,0,0,1,1,1,1,0,0,0
0,1,1,0,1,1,0,1,1,0
0,0,2,2,0,0,2,2,0,0
0,0,0,1,1,1,1,0,0,0
0,0,0,0,1,1,0,0,0,0
========
0,0,2,0,0,0,0,2,0,0
0,2,2,2,0,0,2,2,2,0
2,2,2,2,2,2,2,2,2,2
1,3,4,2,2,2,2,4,3,1
1,1,3,3,2,2,3,3,1,1
0,1,1,3,2,2,3,1,1,0
0,0,1,1,2,2,1,1,0,0
0,0,0,1,2,2,1,0,0,0
0,0,0,0,1,1,0,0,0,0
========
0,0,0,0,0,0,0,0,0,0
0,0,0,0,0,0,0,0,0,0
0,0,0,0,0,0,0,0,0,0
0,0,0,0,0,0,0,0,0,0
0,0,0,0,0,5,0,0,0,0
=========
